############################
#                     #    #
#                     #    #
#                     #    #
#                     #    #
#                     #    #
#                     # cc #
#                    c# cc #
#                  ^  # cc #
#        c^^ c ^  ##--###--#
# @ c ^^^#######  ##  ccc  #
############################
